he decreased inflammatory cytokine levels further evidenced the anti - colitis effects of blidf.	Causation
where attributes are not at the optimum level for a volunteer ( as reflected in just - about - right, jar, ratings ) this may impact liking.	Correlation
he involvement of oral and general health professionals in strategies aimed at identifying individuals at risk from diabetes through early manifestations and diet programs with functional foods should be maximized in order to retard the development of possible complications. our review deals with the role of intestinal microbiota in the pathogenesis of t2dm.	"Pragmatic Approach"
pared with the control group, the abundance of phylum proteobacteria was significantly higher in the predm group ( p = 0. 006 ).	Correlation
incorporation of c into the tps has brought a reduction in the intensity of vh peaks in the xrd spectrum.	"Causation"
the reasons for the abovementioned difference among samples are strictly linked to the fact that the control sample becomes unacceptable because of the degradation of the whole product, whereas the active samples were mainly refused for the turbidity of the syrup in the containers, which negatively affected the visual quality of the fruit salad.	"Contrastive Explanation"
the created network showed that various genes were involved in inflammatory response.	"Correlation"
for the lower concentrations, the extract tended to decrease the ros production but without significant differences, suggesting that the effect of w70 increased with the concentration.	Correlation
increasing evidence has revealed that modulation of mirna expression via the action of dietary compounds activates their potential capacity to mitigate the pathology of cvds.	"Mechanistic Causation"
a comparative study of natural, formaldehyde - treated and copolymer - grafted orange peel for pb ( ii ) adsorption under batch and continuous mode j.	"No Explanation"
it is involved in glutamine - dependent mtor activation to promote glycolysis in cancer cells.	"Causation"
western blot analysiswhen the experiment was over, all mice were euthanized with anesthetic overdose in combination with co2.	No Explanation
he phenyl moieties attached to the double bound are constrained to adopt an almost planar geometry.	"No Explanation"
ations in ptch1 or smo that lead to the constitutive activation of smo are known to play a role in the carcinogenesis of basal cell carcinoma, glioblastoma, medulloblastoma, and rhabdomyosarcoma [ 14, 15, 16 ].	Causation
influence of high - fat diet on gut microbiota : a driving force for chronic disease risk curr.	"Correlation"
bekiari e. comparative effectiveness of glucose - lowering drugs for type 2 diabetes : a systematic review and network meta - analysis ann.	"No Explanation"
itchell h. m. morris m. j. changes in gut microbiota in rats fed a high fat diet correlate with obesity - associated metabolic parameters plos one 2015 10 e0126931 10. 1371 / journal. pone. 0126931 25992554117.	Correlation
f note, mechanistic studies have been hampered by the fact that only a minority of the incoming capsids can successfully arrive at the nuclear envelope, be imported into the nucleus, and lead to eventual productive infection [ 61 ].	The classification label for the input sentence is "Mechanistic Causation".
in the third event ( 320 – 420 °c ), there was a mass loss of about 10 %, which was due to the decomposition of ga / sc, and the ga / sc used as wall materials may have caused this high weight loss [ 33 ].	Causation
we selected four brain regions ( figure 1c ) in the emotion - related network ( insula, anterior cingulate cortex / middle cingulate cortex ( acc / mcc ) ) and the default mode networks ( precuneus / cuneus and mpfc ) as regions of interest ( rois ).	"No Explanation"
sun j. xu b. microrna - 145 protects cardiomyocytes against hydrogen peroxide ( h2o2 ) - induced apoptosis through targeting the mitochondria apoptotic pathway plos one 2012 7 e44907 10. 1371 / journal. pone. 0044907 23028672139.	"No Explanation"
reover, as reported data originate from an earlier publication [ 16 ], whether these values are valid for modern dairy cows is questionable.	Pragmatic Approach
herein, bariatric surgery has emerged as an effective intervention in morbidly obese patients [ 6, 7, 8 ].	"No Explanation"
daperno m. kucharzik t. 3rd european evidence - based consensus on the diagnosis and management of crohn ’ s disease 2016 : part 1 : diagnosis and medical management j. crohns coliti 2017 11 3 25 10. 1093 / ecco - jcc / jjw1687.	"No Explanation"
he change in mirna expression in the extracellular compartment is associated with specific pathological processes.	Correlation
in six studies, the coexistence of various chds with lvnc was analyzed, and in most of them, it was associated with adverse outcomes ( table 1 and table 2 ).	Correlation
( c ) bar graph of the cross - sectional area of barrels and the density of c - fos + cells under both conditions ( n = 4 mice with ev and n = 5 mice with rab27a shrna, n = 23 slices in each condition ).	"No Explanation"
as with previous retrospective studies, there was no evidence of either acute or chronic complications at a minimum of 12 months follow - up, and no evidence of extraocular tumor spread.	"No Explanation"
planation, however, of this observed action, is now well	"No Explanation"
despite recent advances in the treatment of ovarian carcinomas with specific targeted therapies, especially for angiogenesis and homologous recombination deficiency, the improvement of survival of advanced cancer patients is limited [ 13 ].	"No Explanation"
it means that the rgb values change observed in vocs exposure to sensors would obtain best performance in the optimized system. furthermore, this optimized olfaction visualization system successfully discriminated and clustered the vinegar samples with different storage times.	"Mechanistic Causation"
( a ) schematic representation of normal ( upper panel ) and mutant ( lower panel ) gba1a genes.	"No Explanation"
rging studies also support the compatibility of seaweed extracts and products with other agricultural chemical and non - chemical inputs.	No Explanation
in other cases, although there was no statistical difference in social support, the elderly answered in an interview that the intervention increased positive mood and self - efficacy [ 36 ].	Correlation
in traditional medicine it was used for its antioxidant and anti - inflammatory properties.	"Functional"
since all the samples were collected as part of routine clinical activity, no ethical committee approval was needed.	"Pragmatic Approach"
biological activities and health benefit effects of natural pigments derived from marine algae j. funct.	"No Explanation"
it has been observed that psychoactive agents consumed produce not only structural but also behavioral changes.	"Causation"
at the extreme temperatures of 400 °c and 800 °c, the films ’ average mass losses were about 3 % and 2 %, respectively, less than the control, thereby leading to the same conclusion. 3. 2. 6.	"Causation"
in conclusion, the dynamics of leishmania reservoirs in the european context are complex as there is accumulating evidence that infections with l. infantum are not restricted to dogs and, among domestic mammals, cats can be considered the most important additional reservoir species.	Correlation
( c ) rho - kinase inhibition with y27632 ( 10 μm ) or ha1077 ( 10μm ) prevented activin a ( 20 ng / ml ) - induced α - smooth muscle actin ( αsma ) promoter luciferase activation ( n = 6 – 11 * * * p < 0. 001, * * * * p < 0. 0001 ) and ( d ) protein expression of both αsma and the fibrotic protein fibronectin ( fn ) ( n = 4, * p < 0. 05, * * p < 0. 01 ).	"Causation"
lusionsour findings of a high prevalence of resistance to antimicrobial agents and mdr isolates of salmonella in chickens processed and retailed at outlets of the informal market in gauteng province are likely to be indicative of potential zoonotic, food safety and therapeutic implications posed to workers at the outlets and consumers of improperly cooked salmonella - contaminated chicken meat.	"Causation"
we also observed that owd transgenic plants showed some reduced growth, delayed flowering, and reduced fecundity ( data not shown ).	"Causation"
he patient and diagnostic intervals were associated with an increased risk mortality but were not statistically significant.	Correlation
in the present work, the lower bound υ ^ l is used, as it is thought to be more applicable to address effects of thin layers of graphite that more drastically degrade material integrity.	"Pragmatic Approach"
association between renin - angiotensin system blockade discontinuation and all - cause mortality among persons with low estimated glomerular filtration rate jama intern.	Correlation
the numbers above each panel indicate the serial numbers of the calves.	"No Explanation"
in addition, it could pave the way for tight - binding model research in determining the important hopping integrals.	"Pragmatic Approach"
a representation of the gating strategy is shown in supplementary fig.	No Explanation
we aimed to predict realistic aspect ratios of γ ′ ′ precipitates during the course of technical aging heat treatments using phase - field simulations and therefore the single variant coarsening of chemo - elastically interacting γ ′ ′ precipitates was simulated at 730 °c.	"Causation"
similarly, no impact of iuhs treatment was found for instrumental display color attributes, although a display period effect was observed.	Correlation
. s. a. 104, 15759 – 15764 ( 2007 ). 178933317 m. s. han., jnk expression by macrophages promotes obesity - induced insulin resistance and inflammation.	"Correlation"
luding remarkswith the increase in the aging population, the incidence of ad is escalating.	"Correlation"
hence, our results could not be directly extrapolated to the physiological vagal control of hr.	"Contrastive Explanation"
vertheless, patient adherence may have been affected by requirements for greater dosing frequency or by poor medicine acceptability in certain individuals.	"Pragmatic Approach"
in particular, covax aims to deliver at least 2 billion doses by the end of the year, including at least 1. 3 billion doses to 92 lower income economies [ 26 ].	"Pragmatic Approach"
in this study, cronbach ’ s alpha value for the burnout measurement tool was 0. 719. this scale consists of three subscales : independent emotional exhaustion, depersonalization, and personal achievement.	Correlation
additionally, no body weight loss or death was observed, chronic toxicity was lower and tumour growth inhibition was more significant [ 42 ].	"Correlation"
ko143 alone did not significantly affect tumor growth.	"No Explanation"
for psychiatric indications, ‘ eating disorders ’ ( n = 337 ) was ranked first, followed by ‘ symptoms of depression ’ ( n = 282 ), ‘ symptoms of anxiety ’ ( n = 159 ), and adhd ( n = 140 ).	Correlation
it is worth mentioning that the ti / fe / co / ni chemisorptions could induce the diversified energy dispersions because of the edge structures and adatom types.	Mechanistic Causation
another mechanism between engaging in pro - environmental activities and well - being may be conveyed via learning about the environment.	Mechanistic Causation
hose who were previously physically active viewed their current treatment as a temporary setback.	Pragmatic Approach
his was evidenced by changes in the mrna levels of apoptosis - related markers ( decreased anti - apoptotic bcl2 and increased pro - apoptotic bcl - 2 - associated x protein ( bax ) and bak expression ).	"Causation"
indeed, we detected a significant sk reduction in patients treated with k - binders at month 6 ( −0. 52 ; 95 % ci −0. 86, −0. 18 ; p vs. baseline = 0. 003 ), that persisted at month 12 ( −0. 44 ; 95 % ci −0. 78, −0. 10 ; p vs. baseline = 0. 012 ), whereas it remained unmodified in untreated patients ( p = 0. 638 and p = 0. 587, respectively ).	Correlation
his support the results obtained with the impedometric analysis, where a slowing down of the growth and overall acidification capacity was observed. 4.	"Causation"
nocturia was evaluated using item 7 of the ipss, and two or more episodes of nocturia per night was considered to indicate clinically important nocturia.	"No Explanation"
first, future research needs to further explore different scenarios.	Pragmatic Approach
the mechanism of defence is due to the inhibition of urease enzyme avoiding the helicobacter pylori adhesion to the gastric mucosa.	Mechanistic Causation
he authors concluded that sufficient dietary n - 3 pufas improves retinal ganglion cell function making it less susceptible to iop insult, which may have implications for glaucoma [ 44 ].	"Causation"
overall, there was minimal congruence between akinete abundance, cyanotoxin concentration, and the presence of cyanotoxin biosynthetic genes in either sediment core.	Correlation
he other hand, in s3, ebvs of non - genotyped progeny were estimated as means of their parents ’ ebvs ( table 1 ). the accuracy of gebvs was measured by the pearson ’ s correlation between predicted and true breeding values ( tbvs ) on the progeny at the validated population, animals belonging to the 28th generation.	"Correlation"
in conclusion, these results could be especially relevant given that the evolution of the pandemic is having ongoing effects on employment and, therefore, on the mental health of workers. precarious employmenthealth outcomeswork - family issues = = = = body1.	Correlation
introductionnowadays, the development of active packaging films with multi - functionalities ( e. g., carbon dioxide and ethylene scavenging, moisture absorbing and antioxidant and antimicrobial abilities ) has received growing interest in the food industry [ 1 ].	"Pragmatic Approach"
he patients were diagnosed with numerous sts subtypes and presented different clinical situations.	No Explanation
he seedlings were significantly deformed and stunted, so we have not presented data for these variants ( n30, o300, a180 and a300 ) in table 1 and they were not included in further experiments.	"Causation"
afld is considered to be the hepatic component of metabolic syndrome as its features are similar to those of metabolic disorders such as central obesity, inflammation, insulin resistance, hyperlipidemia, hyperglycemia, hypertension and type 2 diabetes [ 3 ].	Correlation
the effects of this changing wildfire and smoke landscape are a critical public and occupational health issue.	Causation
revision arthroplasty of acetabular component is a challenge for every surgeon because they have to simultaneously deal with the reconstruction of bone defects, adequate implant geometry and stable fixation.	Pragmatic Approach
wo common variants, one with tryptophan ( w ) and the other with arginine ( r ) at position 325, have generated considerable interest as the r - variant is associated with a higher risk of developing type 2 diabetes.	Correlation
herefore, those energy converting systems have to be used in conjunction with high - efficiency energy storage devices to store the converted energy [ 1, 2 ].	Pragmatic Approach
such experimental results demonstrate that the proposed model yields outstanding performance.	"No Explanation"
stronger evidence of the positive effects of acupuncture was found for migraine prophylaxis, headache, chronic low back pain, allergic rhinitis, knee osteoarthritis, chemotherapy - induced nausea and vomiting, postoperative nausea and vomiting, and postoperative pain [ 114 ]. acupuncture is best recognized for its use in treating bodily pain.	Correlation
images are adjusted for contrast, brightness, and intensity.	"Pragmatic Approach"
he reversible capacity reached 85 mah g−1, corresponding to a capacity retention of 94. 1 %, even after 350 cycles, when coupled with a na3v2 ( po4 ) 3 cathode.	"No Explanation"
generally, pathogens retain survival or beneficial mutations during host adaptation induced speciation.	Functional
he adatom chemisorptions are relatively easily observed in the ti systems with the largest binding energies.	"Causation"
they then switched to electrophoresis in agar gels to separate the different shapes of the dna they extracted, with the problem of not being able to visualize the running bands in the gel.	"Pragmatic Approach"
the results showed two bands with different sizes.	No Explanation
several inflammatory foci within the hepatic lobule ( black arrow ) and enhanced hepatocyte ballooning ( red arrow ).	"No Explanation"
xu r. antitumor effects of laminaria extract fucoxanthin on lung cancer mar.	"No Explanation"
first, it facilitates tumor - directed mutational analyses to improve sensitivity of peripheral blood testing for germline rb1 mutations [ 17 ].	"Mechanistic Causation"
the descriptive statistics of the variables in this study are shown in table 2.	"No Explanation"
he clinical importance of assessing tumor hypoxia : relationship of tumor hypoxia to prognosis and therapeutic opportunities antioxid.	"Correlation"
part 1 : effects of different enzymatic treatments on solid and protein recovery and flavor characteristics bioresour.	"No Explanation"
poor sleep quality is frequently mentioned by students [ 51 ] ; this issue can increase during lockdown periods and it is more serious for those with anxiety, depression and stress disorders which tend to intensify in isolation [ 29, 52, 53 ].	"Causation"
such mutations lead to increased abundance of the protein by disrupting the recognition by the corresponding e3 ligase.	Causation
friggens n. c. lameness detection via leg - mounted accelerometers on dairy cows on four commercial farms animal 2015 9 1704 1712 10. 1017 / s1751731115000890 2604062639.	"No Explanation"
( b, c ) hek293 cells were co - transfected with a grhl3 - specific luciferase reporter construct and expression vectors for the grhl3 variants shown in ( a ).	"No Explanation"
r hypoxia is a key feature in glioblastoma, and this can be further exacerbated by vascular damage and reduced perfusion caused by irradiation [ 114 ].	"Causation"
izuno k. tsuji t. takebayashi t. fujiwara t. hase k. liu m. prism adaptation therapy enhances rehabilitation of stroke patients with unilateral spatial neglect : a randomized, controlled trial neurorehabilit.	"No Explanation"
aeda h. hosokawa m. sashima t. funayama k. miyashita k. fucoxanthin from edible seaweed, undaria pinnatifida, shows antiobesity effect through ucp1 expression in white adipose tissues biochem.	"No Explanation"
an appropriate response to this problem requires a multifactorial and multidisciplinary heath intervention.	Pragmatic Approach
he investigated compound exhibited a cytostatic action and significantly arrested cell proliferation at the g2 / m phase.	"Causation"
levels of 4 - hydroxynonenal and malondialdehyde are increased in brain of human chronic users of methamphetamine j. pharmacol.	"Correlation"
for microstructural investigations, the jeol 2100 transmission electron microscope ( tem ) equipped with jeol energy dispersive spectroscopy ( eds ) detector ( akishima, tokyo, japan ) has been used.	Pragmatic Approach
because of their good sensitivity, rapidity, and easy operation, biosensors have been developed and widely used.	"Pragmatic Approach"
while lpv allows sufficient o2 transfer the co2 removal is limited, evoking serious side effects.	"Causation"
furthermore, the prevalence of prediabetes and dm was found to be six - fold higher in nafld patients compared to healthy controls.	"Correlation"
introductionmarine algae are attractive rich sources of natural compounds with various biological activities.	**No Explanation**
interestingly, the dual inhibitor was able to overcome bortezomib resistance, while the combination of two inhibitors failed to re - sensitize cells.	"Causation"
according to the world health organization ( who ), more than 80 % of the world ’ s population still rely on plant - based traditional medicines for primary health care [ 14, 15 ].	"Pragmatic Approach"
one such set of protocols was formulated by wayne b. jonas as a method to rebalance the evidence hierarchy in a way that orients the methodology used depending on the type of information the provided.	Pragmatic Approach
bhinani n. patra s. stigma experienced by caregivers of patients with severe mental disorders : a nationwide multicentric study int.	"No Explanation"
karyotyping, performed during the first drainage of the amniotic fluid, revealed no specific chromosomal abnormalities.	"No Explanation"
therefore, hyperthermia is an important confounding factor for understanding of the specific neurotoxic effects induced by meth.	"Causation"
however, whether the metabolic production of met - met confers protection remains obscure.	"No Explanation"
he results show that only compounds 10 and 13 exhibited moderate antibacterial activities against gram - positive bacteria, while the other tested compounds displayed mic values of more than 128 µg / ml.	"Causation"
baseline characteristics of patientsamong 194 screened patients, 51 met the inclusion criteria, and their treatment data were analyzed.	"No Explanation"
he adverse influence of drought on npk could be due to the reduction in nutrient flow and transport under drought [ 81 ].	Causation
although this method needs processed data as an input, it incurs a low computational burden, and the results of the detection are intuitive.	"Pragmatic Approach"
herefore, and carefully, policymakers should weigh the costs of environmental degradation and the benefits of increasing economic growth.	Pragmatic Approach
additionally, it is recommended that patients should also wear a mask when outpatient care service is provided [ 33, 34 ].	"Pragmatic Approach"
hence, experimental results showed better performance compared with other techniques using deep neural networks in term of identification and detection purposes.	"Contrastive Explanation"
reover, data gathered, and the procedures generated can be used in future developments in the hbm area. 4.	"Pragmatic Approach"
valuation of dry feeding and liquid feeding to lactating sows under high temperature environment j. anim.	"No Explanation"
hese results suggest that rac1 promotes cardiac transcription and growth factor expression, leading to cell cycle progression and cardiomyocyte proliferation in the developing heart ( figure 9 ). an earlier report by boczonadi et al.	"Causation"
the effect of changes in the temperature distribution contributes to the deformation of the body through thermal strains and influences the material properties.	Mechanistic Causation
in the mda - mb - 231 cell line, 1624 genes were differentially expressed in the treatment groups ( compared with the control group ).	"No Explanation"
paring results with other tumor entities, a role as an independent prognostic factor was e. g., detected by mrena et al.	**Output**: No Explanation
results are represented as means with standard error of mean ( sem ), and values of p < 0. 05 were considered statistically significant.	"No Explanation"
diffraction peaks corresponding to cuo in figure 2a ( before the treatment ) disappeared in figure 2b ( after the treatment ), and peaks corresponding to cu appeared. this result clearly indicated that cuo nanoparticles were reduced to cu.	Mechanistic Causation
similarly, temperature effects on the material are reflected by changes in the substrate domain temperature.	"Causation"
in addition, working with imputed genotypes, it is important to consider the influence of the imputation error of those snps and therefore ia [ 22, 53 ].	"Causation"
here were no statistically significant differences in loneliness among those in the intervention group ( p > 0. 05 ), but the outcomes were similar to those of the usual care group [ 12, 18, 23 ].	Correlation
functional and biological potential of bioactive compounds in foods for the dietary treatment of type 2 diabetes mellitus.	"Functional"
he relative abundance of the dominant phyla varied, and the bacterial α - diversity was significantly influenced by the seaweed fertilizer application.	Correlation
hese results suggest that e7 - mediated pkm2 upregulation is context - dependent. in summary, we showed that the hpv16 e7 oncoprotein not only interacts with pkm2 but also upregulates its expression.	"Causation"
sc - derived exosomes have also been established to be beneficial in the context of ischemic diseases by promoting the initiation of angiogenesis.	"Causation"
stemness - like networksa great number of signal cascades are shared by carcinogenesis and fibrogenesis.	"Correlation"
he role of sdf - 1 and cxcr4 on odontoblastic differentiation in human dental pulp cells int.	"No Explanation"
where indicated in the figures, * p < 0. 05, * * p < 0. 01, * * * p < 0. 001, * * * * p < 0. 0001. 3.	"No Explanation"
randomized control trials may provide stronger evidence for this issue, but may not be practical owing to ethical concerns.	Pragmatic Approach
higher prevalence data are known for infants and children as compared to adolescents and adults, which is due to tolerance induction in the majority of children when reaching school age.	Causation
dietary weight loss and exercise interventions effects on quality of life in overweight / obese postmenopausal women : a randomized controlled trial int.	"Correlation"
for example, study participants perceived themselves as delaying or inconveniencing others leading to heightened anxiety.	"Functional"
accumulating evidence suggests that the modulation of mirnas may be an important biological strategy to attenuate pathological conditions of cvds by natural antioxidants derived from dietary supplementation [ 157 ].	"Correlation"
hree different o1s peaks were shown at 530. 5 ev, 532 ev and 534 ev binding energies, which were assigned to c – o quinone type ( oi ), c – oh phenol and / or c – o – c ether ( oii ) and cooh carboxylic groups ( oiii ), respectively.	"Causation"
during prolonged er stress, enhanced ire1α kinase activity can phosphorylate the downstream jnk target to induce cell death.	"Causation"
arly experiments in ybco single crystals also reported somewhat higher ρcc ( t ) and a semiconducting behavior below 200 k [ 1, 34 ].	"No Explanation"
he number and the severity of the metabolic abnormalities gradually increase across the spectrum of nafld from patients with nafl to nash without and with advanced fibrosis [ 15 ].	Correlation
isolation, culture conditions, storage methods, and administration of mscs have a significant impact on cell efficacy and survival and could also be problematic in terms of reproducibility and their high cost [ 35, 36 ].	Causation
in fact, trials using fractions of seaweed extracts have reported that no single fraction was able to replicate all the effects seen when the whole original extract is used.	"Causation"
double positive gfp + / neurofilament + cells were detected, indicating that cxcl12 - gfp + cells do not have a neuronal identity.	"Correlation"
b phase contrast and fluorescence images of gcamp6s illustrating the differentiation of transgenic ipscs into neurons.	"No Explanation"
since the development of urbanization and the improvement of living standards, msw disposal has become one of the most critical public health issues challenging developing countries and regions.	"Causation"
w drugs from the sea : pro - apoptotic activity of sponges and algae derived compounds mar.	"No Explanation"
in another work, schnermann ’ s team used a cyanine - based photo - responsive prodrug capable of releasing conjugated payload under nir ( 690 nm ) [ 655 ].	No Explanation
in general, the scenario is conducive to the appearance of relatively serious mental health problems, the scope of which has not yet been clearly delimited. an objective of this article is to study the labour market effects of the covid - 19 pandemic and as such, ample evidence exists of a relationship between work status and well - being.	Correlation
in addition, its also provides better thermal distribution that allows the improvement of the warpage condition [ 15 ]. 5. 2.	Functional
another japanese non - dialysis ckd cohort also reported that low bmi ( 18. 4 – 20. 3 ) was associated with significant risk of all - cause mortality and infection - related death [ 35 ].	Correlation
soil c and n loss and deposition in the watershed were assessed and the relative contributions of each source quantified by a stable isotope mixing model ( siar ).	Correlation
however, when stratified by levels of physical activity, they found association in one of the strata.	Correlation
he epigenetic changes, like gene expression, were also dependent on the specific stressor or their combination.	Correlation
he first limitation stems from the use of a single data source to obtain the final sample, which means relevant documents not indexed in the wos were excluded.	"Pragmatic Approach"
ly then it is possible to conclude which variables ’ long - run deviations from the equilibrium will impact the short - run dynamics.	Correlation
he dataset was processed to estimate missing values, removing the features with > 50 % missing values and replacing the remaining ones by using 1 / 5 of the minimum value of each variable.	"Pragmatic Approach"
however, this very weak signal is apparently convoluted with the one attributed to c = c bonds.	"Contrastive Explanation"
such individual tailoring may however be desirable in programs where coaches want to take into account the individual strengths and limitations of users.	"Pragmatic Approach"
demonstrated that rosmarinus officinalis l. eo was able to induce a dose - dependent reduction of, whereas a dose - independent effect was observed for nanoemulsions whose activity was greater than pure eo [ 39 ].	"Causation"
results and discussionthe descriptive statistics of the heavy metal and trace element levels found in the breast milk samples are shown in table 3.	"No Explanation"
fortunately, the complexity of their busy lives prevented in - depth and consistent use of the khp toolkit for some participants during participation in this research.	**Pragmatic Approach**
hese identified codes were categorized thematically and by color to bring clarity to the coding process.	Pragmatic Approach
maeda h. hosokawa m. sashima t. funayama k. miyashita k. fucoxanthin from edible seaweed, undaria pinnatifida, shows antiobesity effect through ucp1 expression in white adipose tissues biochem.	"Causation"
instrumentationlightning is the electrical discharge phenomena from which the electromagnetic radiations of different wavelengths and different frequencies are being radiated.	"Functional"
we used bioinformatics methods to predict the antidepressant effect of ten natural compounds with neuroleptic activity, reported in the literature.	"Pragmatic Approach"
f note, not only obesity has been associated with depression, but also depressed patients would seem at risk of overweight [ 27 ].	"Correlation"
prove the utter harmlessness of the procedure, they demonstrate the radical	"No Explanation"
reover, at a high current density of 1500 ma g−1, its specific discharge capacity was averaged at 196. 1 ma h g−1 over 200 cycles.	"No Explanation"
reover, it is important to note here that any reference to diversity values that are similar or equal between communities does not insinuate that these communities do not differ.	Correlation
his clinical practice ’ s implementation has also demonstrated a beneficial effect of hep on cancer patient survival discrete from its anticoagulant properties [ 203 ].	"Causation"
rage knock - out lupus mice exhibited a delay in apoptosis of cd3 + b220 + cd4 − cd8 − autoreactive t cells, and an increase in these pathogenic t cells was thought to exacerbate the disease [ 85 ]. 5.	"Causation"
hese data are supported by the observation that autophagy protects ecs from high - glucose - induced injury [ 84 ], as has also been reported in diabetic patients, in whom the restoration of autophagy was found to preserve endothelial function, promoting enos activation, thus confirming that intact autophagy is necessary for enos signaling [ 85 ].	Mechanistic Causation
spleen samples were collected during necropsies performed over carcasses of animals found dead or provided by hunters from 2004 to 2010.	No Explanation
he basal activity of autoinhibited pump and constitutive active variant of pmca3 lacking c - terminal domain was also compromised.	"Causation"
aramori s. cristino v. argazzi r. meda l. tacca a. nanostructured photoelectrodes based on wo3 : applications to photooxidation of aqueous electrolytes chem.	"No Explanation"
hese regions showed an extended conformation in the complex, presumably because it allows a better binding of the protein and trna.	"Causation"
he analytical solution allowed the identification of three boundary cases or regimes, with each case having its distinctive characteristics.	"No Explanation"
however, similar clinical signs were shown in different respiratory diseases that are essential to improving the diagnostic assay to detect ibv infections.	"Pragmatic Approach"
to show the superiority and generality of our method, we adopt it and compare it with different models in the experiments.	"Pragmatic Approach"
for product m1, this may be caused by the pore structure of 4a zeolite being blocked after subjecting to heat treatment at 800 °c, which results in the weakening of its water adsorption ability.	"Causation"
p - gp and bcrp positive cases were, respectively, 52 % and 74. 5 %, with a significantly higher expression of bcrp than p - gp.	"Correlation"
he chronic form presents a th17 / th22 profile, with high production of il - 17 and il - 22, also secreting th1 cytokines such as ifn - γ, tnf - α, il - 2, and variable levels of il - 10 and il - 4, and increased levels of specific igg1 antibodies, contributing to milder clinical manifestations.	"Causation"
adequate goodness of fit was obtained : χ2 = 21. 63 ( p = 0. 303 ), rmsea = 0. 028 ( 95 % confidence interval : 0. 001 to 0. 073 ), cfi = 0. 995, tli = 0. 989, and srmr = 0. 066.	"Correlation"
to analyze whether impaired cdc42 signaling is responsible for the reduced invasion caused by wnt5a knockdown in these melanoma cells, we stimulated the cells with a cdc42 and rac1 activator.	"Causation"
additionally, combinatorial cancer therapies might negatively impact t cell responses, as shown in a phase iii peptide vaccination study combined with the tyrosine kinase inhibitor sunitinib [ 117 ].	"Causation"
in figure 3, especially for coll90 / 10bg material, the random distribution of fiber - like structure was observed. 3. 4.	No Explanation
seeding non - invasive rt4 cells resulted in the formation of a stratified cell layer on top of the de - epithelialized basal membrane ( figure 6 ( ac ) ).	"Functional"
a decade of casp : progress, bottlenecks and prognosis in protein structure prediction curr.	No Explanation
the same sample was highly positive in the generic assay, indicating that most of the hepatotoxins were of microcystin origin.	"Causation"
This suggests that Bmp signaling would be indirectly affected when the levels of miRNA-221-3p are altered.	"Causation"
Karahalios A Pega F Aitken Z Milner A Simpson JA Kavanagh AM The cumulative effect of living with disability on mental health in working-age adults: an analysis using marginal structural models Soc Psychiatry Psychiatr Epidemiol 2020 55 309 318 3090324022.	"No Explanation"
some differences were likely due to the different sample sizes and distributions of the analyzed isolates by the two genotyping methods.	"Contrastive Explanation"
Aspects that could be associated with ON (Eating Disorders [EDs], obsessive-compulsive symptomatology, perfectionistic traits, anxiety, depression, Body Mass Index [BMI]) were investigated in all groups.MethodsThe sample consisted of 329 adults belonging to four different groups.	Correlation
a previous study has reported that afb1 at 3 – 30 μm decreased transcript level of claudin - 3 and occludin in differentiated caco - 2 cells [ 59 ], consistent with the present study results.	"Causation"
another limitation was based on the fact that we did not compare the accuracy of these classification algorithms with other lipid staining methods, such as the oil red procedure ; however, our results indicate that the use of specific fat staining procedures, such as sudan, may be a good choice for the automatic determination of me in pre - transplant liver biopsies, using minimal requirements with optimal results for those cases with low – average amounts of fat infiltration.	"Pragmatic Approach"
In contrast, and as pointed out in the introduction, Barth et al.	"No Explanation"
The percentage of individuals born from 2015 to 2020 that were genotyped ranged from 5 to 21%.	Correlation
A total of 341 S. enterica strains were isolated from retail meat in sixteen districts of Beijing, China, at three different time points (January 1st, May 1st, and October 1st) in 2017.	No Explanation
No development of heart disease was detected in patients who did not carry the p.Arg652Lys variant.	"Causation"
he 12 patients in this group were older ( mean age 80. 58 ± 9. 25 vs. 38. 75 ± 5. 17, p < 0. 0001 and 71. 22 ± 10. 46, p = 0. 005 ) and had more severe disease ( mean respiratory rate : 39 ± 9 vs. 14 ± 1, p < 0. 0001 and vs. 20 ± 7, p < 0. 0001 ; mean spo2 : 88 ± 3 vs. 96 ± 1, p < 0. 0001 and vs. 92 ± 1, p < 0. 0001 ), with co - morbidities including heart failure ( 12 / 12, 100 % ), diabetes ( 5 / 12, 42 % ), and copd ( 6 / 12, 50 % ).	"Correlation"
The same observed phenomenon happened in another study, at the dose of 10 g XOS per day [88].	"No Explanation"
The UK variant is mutant of SARS-CoV-2 that was noted in November 2020 from a sample taken in the UK in September.	No Explanation
r results showed that treatment of cmlt1 with various concentrations of il - vx starting from 100 nm resulted in g0 / g1 arrest ( figure 5b ) in live cells and inhibited their proliferation.	"Causation"
patient caregivers reported that the usage of ppe became more important during the coronavirus pandemic and that they had to face short - time shortages of ppe in the first peak of the pandemic in march 2020.	"Correlation"
EVN neurons were confirmed as cholinergic by double-labeling with antibodies against EYFP (ChR2) and choline acetyltransferase (ChAT), the enzyme responsible for the synthesis of acetylcholine.	"Mechanistic Causation"
p - values < 0. 05, < 0. 01, and < 0. 001 are indicated by *, * *, and * * *, respectively.	"No Explanation"
The results indicated that FTO 3'-UTR-WT was greatly reduced by miR-607, while FTO 3'-UTR-Mut showed similar expression levels in the miR-NC group and miR-607 group (Figure 6D).	"Causation"
However, participants with deformation over 30° showed a significantly lower range of motion in the SLUMPleft test than participants with less severe scoliosis, which may indicate some relationship between spine deformation and MNS.Statistical analysis of painless participants showed increased mechanosensitivity in ULNT1 and SLUMP tests in adolescents with IS.	Correlation
vel mechanism for prolonged retention of topically applied steroid in airway tissue drug metab.	"Causation"
proteasome inhibitors ( pi ) itself induces er stress, thus targeting er stress ( verapamil, wrr139, kw - 2478, and ver15508 ) in combination with pi leads to increased cellular death.	"Causation"
laminin supplemented ada - gel promoted an increase in neuronal differentiation in comparison to pristine ada - gel, with enhanced neuron migration from the neurospheres to the bulk 3d hydrogel matrix.	"Causation"
This may be due to the fact that social donations are the most easily-accessible environmental activities for people to participate in at the organizational level in mainland China.In summary, although it seems that the self-interested NIMBY movement is more likely to attract attention (Yang, 2005; Li et al., 2012), our empirical research here shows that altruism and awareness of the ecological crisis can promote people's engagement in pro-environmental behaviors in China.	Causation
Thus, overall it appears that increased local unionisation shifts production towards being more capital-intensive.Fifth, when we look closer at the regional productivity growth based on the entry and the exit firms only, we see that when local unionisation grows and causes local productivity growth, firm entry contributes significantly to this result.	Causation
This information includes the need for discontinuation of an antithrombotic drug, protection of mobile teeth at an oral surgery clinic, and application of a foot pump due to the high risk of deep vein thrombosis.	Pragmatic Approach
Results: The analysis revealed that frequencies of non-classical-CD14+CD16++ monocytes were lower in HFrEF patients compared to the control group (6.98 IQR: 4.95–8.65 vs. 8.37 IQR: 6.47–9.94; p = 0.021), while CD14++CD16+ and CD14++CD16− did not differ.	Correlation
It is known that mechanical disorders, such as disturbed tensile strength, nerve gliding disturbance (the limited movement of the neural structures relative to other tissues) or compression (pressure-induced deformation) of the nerve, may decrease neural tissue extensibility and cause irritation.	Causation
he cell attachment events were monitored by using a fluorescent microscope in terms of the number of captured cells.	"No Explanation"
It probably improves sleep less than amitriptyline but also causes less sedation [30].Mirtazapine tablets, 30 mg nocte.	"Contrastive Explanation"
his complicates contaminant discovery and analysis studies since parts of noncontaminant metabolites that failed to align with the catalogued spectra are treated as signals from potential contaminant metabolites. an example is the internal reference compound sodium trimethylsilylpropanesulfonate ( dss ), which has a prominent peak at 0 ppm, but also has secondary peaks around 0. 6, 1. 6, and 2. 9 ppm.	"Causation"
kjaerulff o. drosophila rab2 controls endosome - lysosome fusion and lamp delivery to late endosomes autophagy 2018 14 1520 1542 10. 1080 / 15548627. 2018. 1458170 2994080440.	No Explanation
Revision arthroplasty of acetabular component is a challenge for every surgeon because they have to simultaneously deal with the reconstruction of bone defects, adequate implant geometry and stable fixation.	"Causation"
For example, a recent study described that 5 different biochar types, which were evaluated as supplements for anaerobic digestion, retained Fe, Co, Ni and Mn [38].	"Causation"
adjustment for sex, family history of diabetes and hla genotype did not change the results for islet autoimmunity ( 1. 11 ( 0. 86, 1. 43 ), p = 0. 43 ) or type 1 diabetes ( 1. 14 ( 0. 82, 1. 58 ), p = 0. 45 ).	"Correlation"
he analysis of intracellular changes in hepg2 that occurred 16 h after exposure to sio2 nps allowed a closer look at the mechanisms of early cytotoxicity.	Mechanistic Causation
Holstein cows in moderate body condition show even higher leptin levels of 9–10 ng/mL [64].	Correlation
Arrow points to GFP but not FG-positive EVN neuron.	"No Explanation"
in figure 3, especially for coll90 / 10bg material, the random distribution of fiber - like structure was observed. 3. 4.	"No Explanation"
he two groups did not show significant differences in terms of age at operation, sex, bmi, asa score, preoperative cea and ca 19 - 9, preoperative biliary or pancreatic drainage, preoperative cholangitis, eras group, pj method, tumor type, cancer or non - cancer, and resection margin status.	"No Explanation"
In contrast to growth factor-induced mTORC1 stimulation, ubiquitination of TSC2 at K8 does not contribute to mTORC1 regulation by amino acids [89].	Contrastive Explanation
some extent, the improvement was observed in most of the participants in cases of clinical and biological responses.	Correlation
he dataset was processed to estimate missing values, removing the features with > 50 % missing values and replacing the remaining ones by using 1 / 5 of the minimum value of each variable.	"Pragmatic Approach"
Therefore, the study did not require the approval of an ethics committee or informed consent.3.	"Pragmatic Approach"
patients with psychiatric diseases often have a history of childhood neglect, indicating that early - life experiences predispose to psychiatric diseases in adulthood.	Correlation
an average particle size of 893. 3 nm was estimated based on the histogram of the particle size distribution of figure 4c.	"No Explanation"
Both groups of patients did not differ in relation to clinical results, complications and survival at 13 years.	"Correlation"
Some may think animals have the right to life (not to be killed and eaten), while others may believe animals do not have the right to life, but they do have the right to not suffer.	"Contrastive Explanation"
We, therefore, performed this meta-analysis using the rates to obtain a more reliable conclusion by pooling rates from multiple studies.	Pragmatic Approach
additionally, the values of maximum adsorption capacity for cobalt ferrite revealed that this adsorbent is selective for cr, while cobalt ferrite – chitosan composite is selective for mo. kinetic modeling, by the non - linear method, demonstrates that the kinetics of the adsorption process of cr / mo on cobalt ferrite / cobalt ferrite – chitosan composite are different in single - component and binary solutions.	Mechanistic Causation
additionally, it solved many of the outstanding issues with other specialized coating material that required special equipment and techniques like dipping, enrobing, and encapsulating.	"Pragmatic Approach"
levine h. jørgensen n. martino - andrade a. mendiola j. weksler - derri d. mindlis i. pinotti r. swan s. h.	"No Explanation"
heless, requirements for greater dosing frequency or poor acceptability in certain patients could affect adherence.	Pragmatic Approach
ice were anesthetized with isoflurane ( baxter, ca, usa ) before blood collection and tissue analyses at indicated time points.	"No Explanation"
hemical and structural properties of carbonaceous products obtained by hydrothermal carbonization of saccharides chem.	No Explanation
The samples were analysed in three different Spanish laboratories: Health in Code (A Coruña, Spain), Imegen (Valencia, Spain), and Unidad de Diagnóstico Molecular y Genética Clínica del Hospital Universitario Son Espases (Mallorca, Spain), according to availability at the time of evaluation of each patient.The technique used for index patients was Sanger or Next Generation Sequencing (NGS).	Pragmatic Approach
Note: Proofs for Front Matter articles (Pearls, Reviews, Opinions, etc...) are generated on a different schedule and may not be made available as quickly.Soon after your final files are uploaded, the early version of your manuscript, if you opted to have an early version of your article, will be published online.	No Explanation
The attempt made by the authors to study the conceptualization of community engagement across fields will therefore comes with the challenges they have experienced.	**Pragmatic Approach**
zippelius a. schreiner j. herzig p. muller p. induced pd - l1 expression mediates acquired resistance to agonistic anti - cd40 treatment cancer immunol.	No Explanation
One crucial challenge to be addressed related to drug testing for cancer models is that the majority of drugs show intratumor heterogeneity, while others are uniformly toxic in all cases.	"Pragmatic Approach"
swing phase between MGL and MC has not been identified as a central theme in the literature until now.	"No Explanation"
reover, the reduction in size of the wound was found significant according to the analytical method used, thus authors demonstrated that the eo is able to promote the wound healing.	"Causation"
They don’t want their children using glasses, because their eyes will get worse.	"Causation"
In all zoom panels, the first image to the left shows Fast Blue-labeled cells, the second shows CTB-labeled cells, and the third image is an overlay of the two previous images.	No Explanation
In the Arabidopsis fad2 mutant, the UDTFA value was 94% of the WT level, indicating that the PUFA content was not significantly reduced.	"Causation"
some studies with high disparity were removed from analysis to control high heterogeneity.	Pragmatic Approach
Xu R. Antitumor effects of laminaria extract fucoxanthin on lung cancer Mar.	"No Explanation"
2011, college station, tx, usa ) and statistical significance was defined at a p - value < 0. 05 using two - sided tests. 3.	No Explanation
Drosten, C, Bernhard Nocht Institute for Tropical Medicine, National Reference Center for Tropical Infectious Diseases, Hamburg, Germany (144)	"No Explanation"
To address one reviewer's point about the definition of Community Engagement, we've typically used the Centres for Disease Control definition when pressed, but the point, perhaps, is that we were not convinced by past definitions, hence conducting this realist synthesis.	Pragmatic Approach
• Prophylactic treatment should be considered for chronic tension-type headache when there is insufficient effect of non-pharmacological treatment.	"Pragmatic Approach"
we show that rac1 signaling is crucial for ventricular myocardium development and cardiomyocyte specific deficiency of rac1 leads to a spectrum of chds including a thin compact myocardium and hypertrabeculation, similar to clinical features of lvnc.	"Causation"
linical relapses during the follow - up period were observed in 7 / 25 patients and the edss was not increased after the 24 months of treatment ( before treatment : 4. 0 ± 1. 5 ; after treatment : 3. 8 ± 1. 6 ).	"Correlation"
images of cresyl violet staining were taken using an inverted montaging microscope ( model ti2e wideview, nikon, japan ) set with a 2. 5× objective lens.	"No Explanation"
Patients should start with an O2ptimask with 3 l reservoir and if the effect is insufficient, they should try an oxygen demand valve mask before the effect of oxygen can be excluded.	"Pragmatic Approach"
additionally, profiles of volatile compounds were acquired and compared with literature data.	"No Explanation"
Zeba N. Morphological characterization, character association and path analysis of bitter gourd (Momordica charantia L.) genotypes Plant Cell Biotechnol.	"No Explanation"
herein, rossi et al., as well as proving that eos present a strong toxicity against larvae and pupae of the main malaria vectors an.	"Causation"
The increases in NCB near to the beginning and end of the net rainfall perturbation (a and b) are due to the peatland water tables falling and later rising into the zone of maximum litter addition in DigiBog’s litter production equation.Our more detailed model shows aCAR and NCB (Fig.	"Causation"
grp ’ s causative role in migraine has been shown in animal and human studies, when intravenous administration of cgrp induces pain and headaches [ 443, 444 ].	Causation
sing their pcr - based detection protocols, they could not detect any of the tested microorganisms in the mixed sludge sample from the holding tanks.	"No Explanation"
he authors concluded that sufficient dietary n - 3 pufas improves retinal ganglion cell function making it less susceptible to iop insult, which may have implications for glaucoma [ 44 ].	"Causation"
his could be attributed to the fact that there were no recent studies available in the literature.	"Pragmatic Approach"
herefore, these differential pathologic changes may present themselves as distinguishing imaging characteristics during clinical assessments.	"Causation"
The data shows a similar trend with the increase of the recovered yield with the increase of the diol's carbon chain length from C4 to C8 (Figure 6c).	Correlation
We also estimated the effect of the presence of silanol nest in neighboring T-atom positions next to Ti center, which explains the important role of the silanol nest for the stabilization of the MSE-framework upon isomorphous substitution of Si by Ti.	Causation
This result is partly expected due to the country’s large number of research institutions and universities; thus, in absolute numbers, its number of publications is very high.	The classification label for the input sentence is: **Causation**.
besides, many hospital processes and subprocesses are directly and indirectly associated with the surgeries [ 17 ].	Correlation
as shown here, the n501y mutation in all three variants may enhance ace2 affinity but might not confer antibody resistance individually [ 56 ] or neutralizing effects by convalescent plasma and vaccine sera [ 54 ].	"Causation"
The times (minutes) at which the processing status was analyzed are indicated at the top of each lane.	"No Explanation"
as a result, tested eos and plant extracts have demonstrated in vitro antibacterial and antifungal activity against a wide range of organisms, comprising gram - positive and gram - negative bacteria and a yeast [ 55 ].	"Causation"
The SCI model was treated with clemastine and the effect on myelin integrity and neuronal functions was examined.	"Causation"
similarly, blocking of estrogen receptors by specific inhibitors also did not prevent zen - induced apoptosis.	"Causation"
apart from this, melatonin was shown to possess remarkable anti - obesity and metabolic effects, as well as robust cell - protective properties, including anti - inflammatory and anti - apoptotic properties [ 22, 23, 24 ].	Correlation
he optimum content of 15 wt % batio3 showed reduced crystallinity of the cpes and high ion conduction with a wide electrochemical window and good thermal stability.	"Mechanistic Causation"
〈…〉—the Macaulay brackets, which means the following operation:(8) 〈x〉=xifx≥00ifx<0.Therefore, damage factors are not activated in a pure compression state, and allowable shear stresses do not depend on normal stress—see Figure 5.	"Functional"
valuation of the proposed approach with publicly available dataset demonstrates better efficiency compared to existing detection systems in the literature.	"Pragmatic Approach"
Furthermore, our in vivo transmission studies provided much-needed evidence that subclinically infected cattle do not contribute efficiently to virus acquisition by a blood-feeding insect and also further defined the infectious period of the cattle host.	Causation
Between the two top active porous layers, big finger layers can be seen due to the instantaneous de‐mixing.	"Causation"
The fetal kidney contains poorly differentiated tissues that are compatible with gestational development.	No Explanation
IntroductionThe measurements of electromagnetic fields due to lightning radiation have been extensively carried out from the second half of the twentieth century.	"No Explanation"
